10 8
0 0 1 0 0 0 0 0 0 0
0 0 1 0 0 0 0 0 0 0
0 0 1 0 1 1 1 0 0 0
0 0 1 0 1 0 1 0 0 0
0 0 1 0 2 0 1 0 0 0
0 0 1 0 0 0 1 0 0 0
0 0 1 1 1 1 1 0 0 0
0 0 0 0 0 0 0 0 0 0
2 -1
2 6
6 6
6 2
4 2
4 4
