10 6
0 1 1 1 1 1 1 1 1 1
0 1 0 0 0 0 0 0 0 0
0 1 1 1 1 1 1 1 1 0
0 0 0 0 0 0 0 0 1 0
0 1 1 1 1 1 1 1 1 0
0 2 0 0 0 0 0 0 0 0
10 0
1 0
1 2
8 2
8 4
1 4
1 5
